10 10
800 800
2 2 2 2 2 2 2 2 2 2
2 1 0 0 3 7 3 6 3 2
2 0 1 0 3 7 3 6 6 2
2 0 0 1 3 7 3 0 0 2
2 0 0 0 1 7 3 0 0 2
2 0 0 0 1 7 1 0 0 2
2 0 0 0 1 7 1 0 0 2
2 0 0 0 1 7 3 0 0 2
2 0 0 1 0 7 3 0 0 2
2 2 2 2 2 2 2 2 2 2